Material: chât’ liêu, vât liêu,
Material: vât chât’
Raw material: nguyên liêu
Fuel: nhiên liêu
Fuel: tiêp’nhiên liêu cho cai’gi`
Spiritual: tinh thân`
Spirit: linh hôn`, tinh thân`
Spirits: rýõu manh
Communist: công san
Party: ðang phai’, ðôi’tac’
VN communist party: ðang công san viêt nam
Government: chinh’phu
The state: nha`nýõc’
Take care of: chãm soc’ai?
Apply S.TH to: ap’ dung cai’gi` vao` ðâu?
Plastic: thuôc vê` nhýa, ðýõc lam` bãng` nhýa
Iron: sãt’, ban` la`
Glass: thuy tinh, côc’
Wood: gô~
Timber: cây lây’gô~
Steel: thep’
Cloth: vai voc’
Rubber: cao su
Gold: vang`
Golden: thuôc vê` vang`
Silver: bac
Silver: thõ vang`
Lead: chi`
Plantinum: bach kim
Copper: ðông`
Bronze: ðông` thiêc’
Medal: huy chýõng
Diamond: kim cýõng
Nilon: nilông
Cotton: côtông, bông
Composite: chât’tônghõp
Leather: lông, da
Wool: len
China: sý’
Porcelain: gôm’
Paper: giây’
Flour: bôt(j)
Sand: cat’
Stone: ða’
Cement: ximãng
Soil: ðât’ soi
Inox: inox
Jewelry: ðô` trang sýc’, jewellary
Crystal: thach anh
Sthing be made of: vân nhin` thây’chât’liêu
Sthing be made from: không thây’chât’liêu
Sthing be made in: ðýõc lam` õ ðâu
Onion: hanh`
Garlic: toi?
Glutionous: gao nêp’
Salt: muôi’
Salty: mãn
Fat: thit mõ~, beo’(adj)
Green bean: ðâu xanh
Soya: ðâu nanh`
But: ngoai trý`, “I like nothing but a dimond”
Country: nýõc’,(noi’vê`ðia ly’)
Territory: vung` lanh~thô?
Apply S.TH to: ap’ dung cai’gi` vao` ðâu?
On occasion of: nhân ngay`
Earing: bông tai
Pair of: ðôi “pair of earing”


