Swizerland: thuy sy
Swiss: ngýõi` thuy sy
Sweden: thuy ðiên
Swedish: ngýõi`thuy ðiên 
China: trung quôc’
Chinese: ngýõi`trung quôc’
Sweden: thuy ðiên
Swedish: ngýõi`thuy ðiên 
Spain: tây ban nha
Spainish: ngýõi`tây ban nha 
Portugal: bô`ðao`nha
Portugese: ngýõi`bô`ðao`nha 
Japan: nhât
Janpanese: ngýõi`nhât 
Italy: y’
Italian: ngýõi`y’
Iraq: irãc’
Iraqui: ngýõi`irãc’
Russia: nga
Russia : ngýõi`nga 
Korea : han`quôc’
Korean : ngýõi`han`quôc’
France: phap’
French: ngýõi`phap’
Germany: ðýc’
German: ngýõi`ðýc’
Australia: uc’
Australian: ngýõi`uc’
England: anh
English: ngýõi`anh 
The great Britain: liên hiêp anh
British:
Brazil: brazil
Brazillian: ngýõi`brazil
The UK: united kingdom, výõng quôc anh
USA: the united states of amarica: 
Amarican: ngýõi`my~
Administrative: hanh`chinh’
Administrative unit: ðõn vi hanh`chinh’
Province: thu?ðô
Capital: thu?ðô
Central: thuôc trung ýõng
Local: thuôc ðia phýõng
District: tinh?, huyên
Commune: xa~, công xa~
Village: xa~
Ward: phýõng`
Hamlet: thôn xom’

PMU18: project management unit, ban quan ly’dý an’

